PDV = "countries/Vyratia.txt"
MOR = "countries/Mortia.txt"
SMH = "countries/Somarhem.txt"
MAH = "countries/Midarhogg.txt"
VAK = "countries/Vakare.txt"
VRK = "countries/Vrice.txt"
ALT = "countries/Alt.txt"
KER = "countries/Kerolis.txt"
VRE = "countries/Vrettia.txt"
ARE = "countries/Arganese.txt"
VRE = "countries/Vrettia.txt"
DPJ = "countries/Desprian Junta.txt"
DES = "countries/Despria.txt"
RIT = "countries/Itsany.txt"
DOL = "countries/Duchy of Leutia"
TCU = "countries/Talo.txt"
FSO = "countries/Suottomas.txt"
HRT = "countries/Hertogdom Gelre.txt"
RBD = "countries/Renderbosh.txt"
AZE = "countries/Arzule.txt"
BER = "countries/Berka.txt"
BAZ = "countries/Bala Zand.txt"
NAS = "countries/Narli.txt"
OZH = "countries/Hertog Occupation Zone.txt"
OZS = "countries/Suottomas Occupation Zone.txt"
OZB = "countries/Berka Occupation Zone.txt"
OZR = "countries/Rendeboesh Occupation Zone.txt"
COD = "countries/Cornish Duchy"
GEB = "countries/Bolstroe.txt"
BIP = "countries/Bibpop.txt"
ZVD = "countries/Zhong.txt"
SNJ = "countries/Snustxt"
KSC = "countries/Kingdom of Southwark Central"
GBT = "countries/Great Bostroe.txt"
BSC = "countries/Bostroe colony.txt"
TCC = "countries/Talon colony.txt"
NRC = "countries/Narli colony.txt"
DOC = "countries/Leutia colony.txt"
